20,27,27,27,27,27,27,27,27,27,27,26
21,6,2,2,2,2,2,2,2,2,7,25
21,2,5,2,2,2,2,2,2,6,2,25
21,2,2,6,2,2,2,2,7,2,2,25
21,2,2,5,2,2,2,6,2,2,2,25
21,2,2,101,2,2,7,2,2,2,2,25
21,2,2,5,2,2,4,2,2,2,2,25
21,2,2,4,2,2,2,7,2,2,2,25
21,2,2,5,2,2,2,2,4,2,2,25
21,5,4,4,2,2,2,2,2,7,2,25
21,100,2,2,2,2,2,2,2,2,4,25
22,23,23,23,23,23,23,23,23,23,23,24
