20,27,27,27,27,27,27,27,27,27,27,26
21,6,1,2,2,2,7,8,6,2,7,25
21,2,8,8,8,8,1,8,5,6,1,25
21,2,6,1,7,8,2,8,101,7,2,25
21,2,2,8,2,8,2,2,2,2,1,25
21,2,2,8,2,8,2,8,5,6,2,25
21,2,2,8,100,3,2,8,2,2,2,25
21,2,5,2,2,1,2,2,2,2,2,25
21,5,2,1,3,5,4,8,2,5,4,25
21,8,8,5,2,2,2,2,1,8,8,25
21,8,8,8,8,8,8,8,8,8,8,25
22,23,23,23,23,23,23,23,23,23,23,24
