20,27,27,27,27,27,27,27,27,27,27,26
21,1,2,2,2,1,2,2,3,101,0,25
21,1,0,0,0,2,0,0,0,2,0,25
21,1,3,3,3,2,3,3,3,1,0,25
21,1,0,0,0,2,0,0,0,3,0,25
21,1,2,2,2,2,2,2,2,1,0,25
21,1,0,0,0,2,0,0,0,3,0,25
21,1,2,1,3,1,3,2,2,1,0,25
21,1,0,0,0,2,0,0,0,1,0,25
21,100,2,2,2,1,2,2,2,2,0,25
21,0,0,0,0,0,0,0,0,0,0,25
22,23,23,23,23,23,23,23,23,23,23,24
