20,27,27,27,27,27,27,27,27,27,27,26
21,101,2,2,2,2,2,2,2,2,1,25
21,8,1,1,1,1,1,1,1,1,2,25
21,1,1,1,1,1,1,1,1,5,1,25
21,4,2,2,2,2,1,7,7,7,7,25
21,0,0,0,0,0,0,0,0,0,0,25
21,8,1,1,1,1,8,8,1,1,3,25
21,8,0,2,2,3,1,1,0,3,2,25
21,8,3,1,1,0,2,2,3,0,2,25
21,100,1,8,8,1,1,1,1,5,1,25
21,0,0,0,0,0,0,0,0,0,0,25
22,23,23,23,23,23,23,23,23,23,23,24
