20,27,27,27,27,27,27,27,27,27,27,26
21,5,3,6,3,5,3,4,3,7,6,25
21,7,6,1,0,0,0,0,0,0,3,25
21,3,6,1,5,3,7,1,0,0,7,25
21,5,6,0,0,1,1,7,7,7,3,25
21,3,6,0,3,0,0,0,0,4,4,25
21,7,6,0,1,100,1,0,0,4,3,25
21,3,3,0,0,0,1,1,0,4,5,25
21,5,5,5,5,5,3,1,6,4,3,25
21,3,1,0,0,0,0,0,5,1,7,25
21,4,3,5,3,4,3,6,3,7,101,25
22,23,23,23,23,23,23,23,23,23,23,24
