20,27,27,27,27,27,27,27,27,27,27,26
21,8,8,8,1,8,8,8,8,8,8,25
21,8,8,1,2,3,8,2,2,1,8,25
21,8,8,2,8,8,8,8,2,3,8,25
21,8,8,2,2,8,8,8,2,8,8,25
21,2,8,2,2,8,8,8,2,2,8,25
21,2,8,8,2,8,8,2,2,1,8,25
21,2,8,8,3,8,3,2,2,1,8,25
21,2,8,3,2,2,2,3,8,8,8,25
21,2,8,8,2,8,2,8,8,8,8,25
21,1,2,2,100,8,101,1,8,8,8,25
22,23,23,23,23,23,23,23,23,23,23,24
