0,0,0,0,0,0,0,0,0,0
0,0,0,0,0,0,0,1,101,0
0,0,0,0,0,0,1,1,3,0
0,0,0,0,0,1,1,2,2,0
0,0,0,0,1,1,2,2,2,0
0,0,0,1,1,2,2,2,2,0
0,0,1,1,2,2,2,2,2,0
0,1,1,2,2,2,2,2,2,0
0,100,2,2,2,2,2,2,2,0
0,0,0,0,0,0,0,0,0,0
