1,1,1,1,1,1,2,2,6,101
1,0,0,0,0,2,8,1,2,1
1,0,0,0,0,2,8,0,2,1
1,0,0,0,0,2,8,3,2,1
1,2,2,2,2,1,8,0,2,1
2,8,8,8,8,8,8,3,2,1
2,1,2,2,2,2,2,1,2,1
2,0,0,0,0,0,0,0,2,1
2,3,0,0,0,0,0,0,2,1
100,1,1,1,1,1,1,1,1,1
