20,27,27,27,27,27,27,27,27,27,27,26
21,0,0,0,0,0,0,0,0,0,0,25
21,0,0,0,0,0,0,0,0,0,0,25
21,0,0,0,0,0,0,0,0,0,0,25
21,0,0,0,0,0,0,0,0,0,0,25
21,0,0,100,1,1,1,1,101,0,0,25
21,0,0,0,0,0,0,0,0,0,0,25
21,0,0,0,0,0,0,0,0,0,0,25
21,0,0,0,0,0,0,0,0,0,0,25
21,0,0,0,0,0,0,0,0,0,0,25
21,0,0,0,0,0,0,0,0,0,0,25
22,23,23,23,23,23,23,23,23,23,23,24
