5,3,6,3,5,3,4,3,7,6
7,6,1,0,0,0,0,0,0,3
3,6,1,5,3,7,1,0,0,7
5,6,0,0,1,1,7,7,7,3
3,6,0,3,0,0,0,0,4,4
7,6,0,1,100,1,0,0,4,3
3,3,0,0,0,1,1,0,4,5
5,5,5,5,5,3,1,6,4,3
3,1,0,0,0,0,0,5,1,7
4,3,5,3,4,3,6,3,7,101
