20,27,27,27,27,27,27,27,27,27,27,26
21,0,0,0,0,0,0,0,0,0,0,25
21,0,0,0,0,0,0,0,0,0,0,25
21,0,0,0,0,0,0,101,0,0,0,25
21,0,0,0,0,0,1,1,0,0,0,25
21,0,0,0,0,1,1,0,0,0,0,25
21,0,0,0,1,1,0,0,0,0,0,25
21,0,0,1,1,0,0,0,0,0,0,25
21,0,100,1,0,0,0,0,0,0,0,25
21,0,0,0,0,0,0,0,0,0,0,25
21,0,0,0,0,0,0,0,0,0,0,25
22,23,23,23,23,23,23,23,23,23,23,24
