7,7,7,0,0,0,0,0,0,0
7,100,1,7,0,0,0,0,0,0
7,7,1,1,7,7,0,0,0,0
0,0,7,1,1,7,0,0,0,0
0,0,0,7,1,7,0,0,0,0
0,0,0,7,1,7,0,0,0,0
0,0,0,7,1,1,7,0,0,0
0,0,0,7,7,1,1,7,7,0
0,0,0,0,7,7,1,101,7,0
0,0,0,0,0,0,7,7,7,0
