5,2,2,6,8,8,8,5,2,101
2,8,8,2,5,2,2,2,2,4
6,2,7,2,4,6,2,2,2,7
3,8,2,2,8,2,8,2,8,2
2,8,4,7,1,2,2,4,8,2
2,8,8,8,2,5,2,6,8,2
2,5,2,1,1,2,8,2,8,2
2,8,8,8,8,2,8,2,8,2
1,3,8,3,8,4,8,2,8,2
100,1,2,2,2,2,3,7,2,4
