20,27,27,27,27,27,27,27,27,27,27,26
21,0,0,0,0,0,0,0,0,0,0,25
21,0,1,2,1,6,2,2,1,6,7,25
21,0,2,0,2,2,0,0,2,0,4,25
21,0,1,2,2,2,2,2,1,5,4,25
21,0,0,0,2,2,0,0,6,1,1,25
21,0,5,5,4,1,7,7,7,101,4,25
21,0,2,0,0,2,0,0,0,5,4,25
21,0,2,0,0,2,0,0,0,2,0,25
21,0,100,2,7,1,2,2,2,1,0,25
21,0,0,0,0,0,0,0,0,0,0,25
22,23,23,23,23,23,23,23,23,23,23,24
