8,8,8,1,8,8,8,8,8,8
8,8,1,2,2,2,2,1,2,8
8,8,2,8,8,8,8,2,2,8
8,8,2,2,8,8,8,2,2,8
2,8,1,2,2,2,8,1,2,8
2,8,8,2,8,2,2,2,2,8
2,8,8,2,8,2,2,2,2,8
2,8,3,1,2,2,2,1,2,8
2,8,8,2,8,2,8,8,2,8
1,2,2,100,8,101,2,2,2,8
