8,8,8,0,0,0,0,0,0,0
8,100,1,8,0,0,0,0,0,0
8,8,1,1,8,8,0,0,0,0
0,0,8,1,1,8,0,0,0,0
0,0,0,8,1,8,0,0,0,0
0,0,0,8,1,8,0,0,0,0
0,0,0,8,1,1,8,0,0,0
0,0,0,8,8,1,1,8,8,0
0,0,0,0,8,8,1,101,8,0
0,0,0,0,0,0,8,8,8,0
