20,27,27,27,27,27,27,27,27,27,27,26
21,8,8,8,0,0,0,0,0,0,0,25
21,8,100,1,8,0,0,0,0,0,0,25
21,8,8,1,1,8,8,0,0,0,0,25
21,0,0,8,1,1,8,0,0,0,0,25
21,0,0,0,8,1,8,0,0,0,0,25
21,0,0,0,8,1,8,0,0,0,0,25
21,0,0,0,8,1,1,8,0,0,0,25
21,0,0,0,8,8,1,1,8,8,0,25
21,0,0,0,0,8,8,1,101,8,0,25
21,0,0,0,0,0,0,8,8,8,0,25
22,23,23,23,23,23,23,23,23,23,23,24
