0,0,0,0,0,0,0,0,0,0
0,1,2,1,6,2,2,1,6,6
0,2,0,2,2,0,0,2,0,4
0,1,2,2,2,2,2,1,5,4
0,0,0,2,2,0,0,6,1,1
0,5,5,4,1,7,7,7,101,4
0,2,0,0,2,0,0,0,5,4
0,2,0,0,2,0,0,0,2,0
0,100,2,7,1,2,2,2,1,0
0,0,0,0,0,0,0,0,0,0
