8,8,8,8,8,8,8,8,8,8
8,8,8,8,8,8,3,1,101,8
8,8,8,8,8,8,0,0,8,8
8,8,8,8,8,8,3,3,8,8
8,3,3,1,3,1,1,1,8,8
8,1,1,1,1,1,8,8,8,8
8,3,1,1,8,8,8,8,8,8
8,1,3,3,8,8,8,8,8,8
8,100,1,1,8,8,8,8,8,8
8,8,8,8,8,8,8,8,8,8
