0,0,0,0,0,0,0,0,0,0
0,100,3,0,1,0,0,0,0,0
0,0,0,0,3,0,0,0,0,0
0,0,0,0,0,0,0,0,0,0
0,0,0,0,1,3,0,1,0,0
0,0,0,0,0,0,0,3,0,0
0,0,0,0,0,0,0,0,0,0
0,0,0,0,0,0,0,1,101,0
0,0,0,0,0,0,0,0,0,0
0,0,0,0,0,0,0,0,0,0
