6,2,2,2,2,2,2,2,2,7
2,5,2,2,2,2,2,2,6,2
2,2,6,2,2,2,2,7,2,2
2,2,5,2,2,2,6,2,2,2
2,2,101,2,2,7,2,2,2,2
2,2,5,2,2,4,2,2,2,2
2,2,4,2,2,2,7,2,2,2
2,2,5,2,2,2,2,4,2,2
5,4,4,2,2,2,2,2,7,2
100,2,2,2,2,2,2,2,2,4
