1,1,1,1,1,1,1,1,1,101
1,1,1,3,1,3,1,1,1,1
3,1,1,1,1,1,1,1,1,3
1,1,3,1,1,1,1,3,1,1
1,1,1,1,1,1,1,1,1,1
1,1,1,1,3,1,1,1,1,1
1,1,1,1,1,1,1,1,1,1
1,3,1,1,1,1,1,1,3,1
1,1,1,1,1,1,3,1,1,1
100,1,1,1,1,3,1,1,1,1
