20,27,27,27,27,27,27,27,27,27,27,26
21,7,2,2,2,2,2,2,2,2,101,25
21,2,8,8,8,8,8,5,2,2,4,25
21,2,8,8,8,8,8,2,8,8,0,25
21,2,8,8,8,1,1,4,8,8,3,25
21,2,8,8,8,1,8,4,8,5,4,25
21,2,8,8,5,1,8,8,8,2,3,25
21,2,1,1,1,8,8,8,8,2,0,25
21,2,1,8,8,5,2,2,2,7,3,25
21,2,1,2,2,4,8,8,8,8,2,25
21,100,1,3,0,3,0,3,0,5,6,25
22,23,23,23,23,23,23,23,23,23,23,24
