101,2,2,2,2,2,2,2,2,1
8,1,1,1,1,1,1,1,1,2
1,1,1,1,1,1,1,1,5,1
4,7,7,7,7,7,7,7,7,1
0,0,0,0,0,0,0,0,0,0
8,1,1,1,1,8,8,1,1,3
8,0,2,2,3,1,1,0,3,2
8,3,1,1,0,2,2,3,0,2
100,1,8,8,1,1,1,1,5,1
