7,2,2,2,2,2,2,2,2,101
2,8,8,8,8,8,5,2,2,4
2,8,8,8,8,8,2,8,8,0
2,8,8,8,8,8,2,8,8,3
2,8,8,8,1,1,4,8,5,1
2,8,8,5,1,8,8,8,2,3
2,1,1,1,8,8,8,8,2,0
2,1,8,8,5,2,2,2,7,3
2,1,2,2,4,8,8,8,8,2
100,1,3,0,3,0,3,0,5,6
