0,0,0,0,0,0,0,0,0,0
0,0,0,1,2,2,100,0,0,0
0,0,0,1,2,2,1,0,0,0
0,0,0,1,2,2,1,0,0,0
0,0,0,1,2,2,1,0,0,0
0,0,0,1,2,2,1,0,0,0
0,0,0,1,2,2,1,0,0,0
0,0,0,1,2,2,1,0,0,0
0,0,0,1,2,2,1,0,0,0
0,0,0,0,0,0,101,0,0,0
